رحيل مصطفي حجازي رائد علم|نفس|التخلف والقهر رحيل مصطفي حجازي
رحيل مصطفي حجازي رائد علم|نفس|التخلف والقهر من العمل العيادي
1486977211 . jpg ] العالم|النفساني|مصطفي حجازي ( صفحة الكاتب
فيسبوك ) ملخص رحل عالم|النفس|والباحث الاكاديمي اللبناني مصطفي حجازي
، وسعي الي جعل علم|النفس|في خدمة الفرد والمجتمع .
والمجتمع . عندما انتقل العالم|النفساني|اللبناني مصطفي حجازي الذي رحل
سنة ، من حقل علم|النفس|الي عالم التاليف السوسيونفساني ،
علم النفس الي عالم التاليف|السوسيونفساني|، واصدر كتابه الشهير "
احدث ثورة في علم التحليل|النفساني|الاجتماعي وحظي كتابه هذا برواج
يشكل مدخلاً رئيساً الي علم|نفس|التخلف ، ويسهم اسهاماً غنياً
الانسان المهدور : دراسة تحليلية|نفسية|اجتماعية " ، الذي توسع
الانسان المهدور علي ضوء علم|النفس|التحليلي . 145679 . jpg
بل سعي الي جعل علم|النفس|في خدمة الفرد والمجتمع ومتابعة
من الاشتغال في حقل التحليل|النفسي|، ومن تناول هموم المجتمعات
حاز اجازة جامعية في علم|النفس|من جامعة عين شمس المصرية
، ثم دكتوراه في علم|النفس|من الجامعة نفسها عام 1967
في علم النفس من الجامعة|نفسها|عام 1967 . شكلت مرحلة
فاعتُمد منذ عام 1968 خبيراً|نفسانياً|في مراكز رعاية الاحداث في
منصب الرئاسة الفخرية لتجمع "|نفسانيون|" . في مساره الاكاديمي
التي عمل فيها استاذاً لعلم|النفس|منذ 1983 ، ثم عمل
الانسان المهدور : دراسة تحليلية|نفسية|اجتماعية " ( 2006 )
) ، و " علم|النفس|والعولمة : رؤي مستقبلية في
الخليجي والمستقبل : دراسة تحليلية|نفسية|اجتماعية " ( 2008 )
) ، و " علم|النفس|والعولمة : رؤي مستقبلية في
الحياة : قراءات في علم|النفس|الايجابي " ( 2011 )
" اللقاء : كيف يكشفنا|لانفسنا|ويفتحنا علي العالم " (
الكلام او الموت " لعالم|النفس|الشهير المصري الفرنسي مصطفي صفوان
و " معجم مصطلحات التحليل|النفسي|" لجان لابلانش وج بونتاليس
منهجية قائمة علي الملاحظة والتحليل|النفسي|والاجتماعي للظواهر المعيشة . وهي
وهي تدخل في اطار علم|النفس|الاجتماعي العيادي ، الذي يدرس
العيادي ، الذي يدرس الظواهر|النفس|اجتماعية بالطريقة العيادية . ولعل
نوع من المدخل الي علم|نفس|التخلف ، واسهامه الغني جداً
فهي تكمن في طرح منهجية|نفسية|لدراسة الانسان المتخلف في مختلف
ان اي " تكتسح علم|النفس|والاعماق الانسانية * فرويد فشل
احتضاره المزيد عن : عالم|نفسانيعلم|النفسالقضايا الاجتماعيةالقضايا الانسانيةالتخلفالقهرالعيادةبحث اكاديمي المزيد
المزيد عن : عالم نفسانيعلم|النفسالقضايا|الاجتماعيةالقضايا الانسانيةالتخلفالقهرالعيادةبحث اكاديمي المزيد من
